type octile
height 4
width 3
map
. @ .
. . .
@ . @
. . .