type octile
height 15
width 30
map
. . . . . . . . . . . . . . . . . . . . . @ @ . . . . . . .
. . . . . . . . . . . . . . . . . . . . . @ @ . . . . . . . 
. . . . . . . . . . . . . . . . . . . . . @ @ . . . . . . . 
. . . @ @ . . . . . . . . . . . . . . . . @ @ . . . . . . . 
. . . @ @ . . . . . . . . @ @ . . . . . . @ @ . . . . . . . 
. . . @ @ . . . . . . . . @ @ . . . . . . @ @ @ @ @ . . . . 
. . . @ @ . . . . . . . . @ @ . . . . . . @ @ @ @ @ . . . . 
. . . @ @ . . . . . . . . @ @ . . . . . . . . . . . . . . . 
. . . @ @ . . . . . . . . @ @ . . . . . . . . . . . . . . . 
. . . @ @ . . . . . . . . @ @ . . . . . . . . . . . . . . . 
. . . @ @ . . . . . . . . @ @ . . . . . . . . . . . . . . . 
. . . @ @ . . . . . . . . @ @ . . . . . . . . . . . . . . . 
. . . . . . . . . . . . . @ @ . . . . . . . . . . . . . . . 
. . . . . . . . . . . . . @ @ . . . . . . . . . . . . . . .
. . . . . . . . . . . . . @ @ . . . . . . . . . . . . . . .