type octile
height 2
width 6
map
@ @ . . @ @
. . . . . .